"Ontology - parents of class from Gene names"	"Matches"
"2'-deoxyribonucleotide metabolism"	"nrdD"
"ABC superfamily ATP binding cytoplasmic component"	"znuC" // "proV" // "metN" // "ybbL" // "artP"
"ABC superfamily, ATP binding and membrane component"	"cydD"
"ABC superfamily, membrane component"	"fepD"
"ABC superfamily, periplasmic binding component"	"modA" // "malE" // "hisJ"
"Accessory Factors Involved in Transport"	"ptsH"
"acetate catabolism"	"acs"
"activator"	"yneJ" // "uvrY" // "tyrR" // "torR" // "sxy" // "soxS" // "soxR" // "sdiA" // "rhaS" // "rcsA" // "qseB" // "pspF" // "oxyR" // "ompR" // "melR" // "malT" // "lrp" // "leuO" // "ilvY" // "ihfB" // "hns" // "glcC" // "gcvA" // "gadE" // "fnr" // "fadR" // "cytR" // "cusR" // "csgD" // "crp" // "cbl" // "caiF" // "cadC" // "bolA" // "asnC" // "argR" // "arcA" // "araC" // "ada"
"acyl carrier protein"	"acpP"
"adaptations"	"uspA" // "hepA" // "mreB" // "loiP" // "iraP" // "bhsA" // "acrZ"
"aerobic respiration"	"sdhC" // "nuoA" // "glpD" // "frsA" // "dld" // "cyoA"
"alpha-type channels"	"glpF"
"amines"	"nagE" // "caiF"
"amino acid -activation"	"proS" // "metG" // "hisS" // "glyQ" // "gltX" // "argS"
"amino acid conversion"	"aspA"
"amino acids"	"putA" // "purR" // "metB" // "glyA" // "gcvT" // "gcvR" // "gcvA" // "dadA" // "cadC"
"amino sugar conversions"	"nanA" // "nagE" // "nagB"
"anaerobic respiration"	"torR" // "torC" // "pflA" // "nuoA" // "nrfA" // "nirB" // "napF" // "menA" // "hybO" // "grcA" // "frdA" // "fnr" // "fdnG" // "dmsA" // "dcuS"
"antisense RNA"	"ryhB" // "mgrR" // "hfq" // "dsrA"
"antisense RNA"	"ryhB" // "mgrR" // "hfq" // "dsrA"
"arginine"	"carA" // "artP" // "argR" // "argI" // "argE" // "argD" // "argC"
"asparagine"	"aspA" // "asnC" // "asnA"
"ATP proton motive force interconversion"	"zntA" // "atpI"
"Beta barrel porins (The Outer Membrane Porin (OMP) Functional Superfamily)"	"tsx" // "phoE" // "ompF" // "ompC" // "fepA"
"biotin carboxyl carrier protein"	"accB"
"capsule (M and K antigens)"	"waaA" // "manA" // "galE"
"carbon compounds"	"zwf" // "yiaK" // "uxuA" // "uxaB" // "srlA" // "rhaT" // "rhaS" // "rhaB" // "rbsD" // "ptsH" // "ptsG" // "poxB" // "pfkA" // "melR" // "melA" // "mdh" // "manX" // "manA" // "malX" // "malT" // "malP" // "malI" // "lacZ" // "glk" // "glcC" // "gcd" // "galS" // "galR" // "galE" // "focA" // "dcuB" // "dcuA" // "dctA" // "csrA" // "caiT" // "araJ" // "araE" // "araC" // "araB" // "aldA" // "acs" // "acnB" // "aceE"
"cell division"	"tig" // "sulA" // "sdiA" // "nlpD" // "lon" // "groS" // "ftsH" // "dacA" // "bolA"
"cell processes"	"tomB"
"central intermediary metabolism"	"pps" // "pck" // "mdh" // "gpmA" // "gapA" // "eno" // "csrA"
"chaperoning, repair (refolding)"	"tig" // "spy" // "ppiD" // "ppiA" // "hscB" // "groS" // "cpxP"
"chorismate"	"shiA" // "aroL" // "aroK" // "aroF"
"Coenzyme A and its modification"	"panD"
"colanic acid (M antigen)"	"wza" // "rcsA" // "manA" // "galE"
"colicin related"	"tsx" // "purR" // "fepA" // "cirA"
|Conserved-Hypothetical-ORFs|	"ygfB" // "ybjC"
"core region"	"waaA"
"covalent modification, demodification, maturation"	"srkA" // "sixA" // "rcsD" // "ptsG" // "pka" // "glrK" // "dcuS"
"cysteine"	"cysK" // "cbl"
"cytochromes"	"yceJ" // "torC" // "sdhC" // "nrfA"
"cytoplasmic polysaccharides"	"mlc" // "glgB" // "csrA"
"defense/survival"	"hdeA"
"dessication"	"manA"
"detoxification"	"zntA" // "yjjX" // "yjjQ" // "tpx" // "soxS" // "soxR" // "sodB" // "sodA" // "mntH" // "katG" // "ahpC"
"DNA"	"uvrB" // "nfo"
"DNA degradation"	"uvrB" // "nfo"
"DNA recombination"	"xerD" // "ssb" // "recA" // "pepA" // "ihfB"
"DNA repair"	"uvrD" // "uvrB" // "uvrA" // "recA" // "mfd" // "lexA" // "dinI" // "dam" // "ada"
"DNA replication"	"uvrD" // "topA" // "dam"
"drug resistance/sensitivity"	"ssrA" // "nfsB" // "mprA" // "mdtJ" // "dacA" // "ampC" // "acrA"
"Electrochemical potential driven transporters"	"tatA"
"electron acceptors"	"torC" // "nrfA" // "frdA" // "dmsA" // "cyoA"
"electron carriers"	"fldB"
"electron donors"	"sdhC" // "putA" // "poxB" // "nuoA" // "hybO" // "glpD" // "gcd" // "fdnG" // "dld"
"energy production/transport"	"yqjA" // "tonB" // "fixA"
"Entner-Doudoroff"	"edd"
"fatty acids"	"fadR" // "fadD" // "fadB" // "acs"
"fatty acids and phosphatidic acid"	"glpF" // "glnB" // "fabB" // "cfa" // "acs" // "accD"
"Fe aquisition"	"tonB" // "ftnA" // "fhuF" // "ybbL" // "fes" // "fepD" // "fepA" // "bfr"
"fermentation"	"pykF" // "pykA" // "mdh" // "frsA" // "frdA" // "adhE"
"flagella"	"fliL"
"flagellum"	"fliL"
"folic acid"	"pabA" // "folA"
"formyl-THF biosynthesis"	"purR" // "glyA" // "gcvT" // "gcvR" // "gcvA" // "folA"
"galactose metabolism"	"galE"
"global"	"mlc" // "hfq" // "fnr" // "csrA" // "crp"
"glutamate"	"gltB"
"glutamine"	"glnB" // "glnA"
"glycine"	"glyA"
"glycolate metabolism"	"glcD"
"glycolysis"	"tpiA" // "pykF" // "pykA" // "gpmA" // "gapA" // "eno" // "csrA"
"glycoprotein"	"csgB"
"glyoxylate bypass"	"aceB"
"glyoxylate degradation"	"mdh" // "aceE"
"heme, porphyrine"	"znuC" // "hemN" // "hemB" // "hemA" // "gltX"
"histidine"	"purR"
"incorporation of metal ions"	"sufA" // "hscB" // "fes" // "dps"
"information transfer"	"bssS"
"inhibition / activation of enzymes"	"yihI" // "ptsH" // "pflA" // "glnB" // "cyaA"
"Ion-gradient-driven energizers"	"tonB"
"isoleucine/valine"	"lrp" // "ilvY" // "ilvL" // "ilvIH" // "ilvC"
"K antigen"	"waaA" // "rcsA"
"leucine"	"tyrB" // "lrp" // "leuO" // "leuL"
"lipid A"	"waaA"
"lipopolysaccharide"	"imp" // "lapA"
"lysine"	"lysP" // "dapA" // "aspA" // "argD"
"membrane"	"zntA" // "yrbG" // "yqjA" // "yhjX" // "yccA" // "tyrP" // "treB" // "torC" // "tonB" // "tatA" // "shiA" // "secG" // "sdhC" // "rhaT" // "rcnA" // "putP" // "ptsG" // "pssA" // "proP" // "ppiD" // "poxB" // "pgpB" // "ompA" // "nupG" // "nupC" // "nuoA" // "nhaB" // "narK" // "nagE" // "mtr" // "mntP" // "mntH" // "mgtA" // "menA" // "mdtJ" // "manX" // "lysP" // "lgt" // "gntP" // "glpF" // "gcd" // "ftsH" // "focA" // "fieF" // "fepD" // "entS" // "tppB" // "dmsA" // "dld" // "dcuB" // "dcuA" // "dctA" // "cyoA" // "cydD" // "cusC" // "cstA" // "caiT" // "cadB" // "atpI" // "araJ" // "araE" // "acrA"
"menaquinone, ubiquinone"	"purR" // "menA"
"metabolism"	"ade" // "azoR"
"methionine"	"metJ" // "metB" // "metA"
"methylation"	"dam"
"methylglyoxal metabolism"	"aldA"
"misc. glucose metabolism"	"treR" // "treB" // "gntK" // "gcd"
"misc. glycerol metabolism"	"glpF" // "glpD"
"molybdenum"	"moeA" // "modA"
"motility, chemotaxis, energytaxis (aerotaxis, redoxtaxis etc)"	"malE" // "fliL" // "csrA"
"murein"	"mpl" // "bolA" // "ampC" // "amiA"
"murein (peptidoglycan)"	"pgpB" // "dacA" // "ampC" // "amiA"
"murein turnover, recycling"	"mpl"
"nicotinamide adenine dinucleotide"	"pncB" // "nadE"
"nitrogen metabolism"	"purR" // "narK" // "gltB" // "glnB" // "glnA"
"nucleoproteins, basic proteins"	"lrp" // "ihfB" // "hns" // "hfq" // "dps"
"nucleotide and nucleoside conversions"	"upp" // "udpP" // "tsx" // "rihB" // "pyrH" // "pyrF" // "purR" // "purA" // "nupG" // "nupC" // "nrdA" // "mtn" // "hpt" // "guaB" // "gmk" // "deoC" // "deoB" // "cytR" // "cpdB" // "cmk" // "cdd" // "apt"
"operon"	"tyrR" // "trpR" // "torR" // "torC" // "soxR" // "sdiA" // "rhaS" // "rcsA" // "pspF" // "osmE" // "ompR" // "mprA" // "mlc" // "metJ" // "melR" // "malT" // "malI" // "lrp" // "leuO" // "ilvY" // "glcC" // "gcvR" // "gcvA" // "galS" // "galR" // "fadR" // "caiF" // "cadC" // "arcA" // "araC" // "ada"
|ORFs|	"ymiA" // "yjjZ" // "yjeV" // "yibN" // "yfgG" // "yeiQ" // "yegR" // "yajG" // "yacC" // "azuC"
"osmoregulated periplasmic glucan"	"opgG"
"osmotic pressure"	"treR" // "proV" // "proP" // "osmY" // "osmE" // "osmC" // "osmB" // "opgG" // "bolA"
"other (mechanical, nutritional, oxidative stress)"	"ychH" // "ychF" // "srkA" // "soxS" // "soxR" // "rpoE" // "ppiD" // "oxyR" // "hisJ" // "grcA" // "cutA" // "cpxP" // "arcA"
"Oxidoreduction-driven Active Transporters"	"nuoA" // "cyoA"
"pentose pwy, oxidative branch"	"zwf"
"pH"	"yobF" // "nhaB" // "hdeD" // "hdeA" // "grcA" // "gadE" // "cpxP" // "asr" // "adiA"
"phenylalanine"	"tyrB" // "pheL" // "aroG"
"phospholipid"	"pssA" // "plsX" // "pgpB" // "lgt" // "fadD"
"Phosphotransferase Systems (PEP-dependent PTS)"	"ulaA" // "treB" // "srlA" // "ptsG" // "nagE" // "manX" // "malX"
"pilus"	"csgB"
"plasmid related"	"mprA" // "lon" // "ftsH"
"polyamine biosynthesis"	"purR"
"polysaccharides"	"malP"
"Porters (Uni-, Sym- and Antiporters)"	"yrbG" // "yhjX" // "tyrP" // "shiA" // "rhaT" // "putP" // "proP" // "nupG" // "nupC" // "nhaB" // "narK" // "mtr" // "mntH" // "mdtJ" // "lysP" // "gntP" // "focA" // "fieF" // "entS" // "tppB" // "dcuB" // "dcuA" // "dctA" // "caiT" // "cadB" // "araJ" // "araE" // "acrA"
"posttranscriptional"	"sulA" // "ssrA" // "rraB" // "iraP" // "glmY" // "csrB"
"posttranslational modification"	"srkA" // "sixA" // "ycfD" // "rcsD" // "ptsG" // "pflA" // "pka" // "lgt" // "glrK" // "def" // "dcuS"
"prophage genes and phage related functions"	"tsx" // "pspF" // "ompX" // "lon" // "hfq"
"proteases, cleavage of compounds"	"recA" // "lon" // "degS" // "clpP"
"protection"	"yqhD" // "spy"
"proteins/peptides/glycopeptides"	"sohB" // "ptrA" // "pepD" // "pepA" // "lon" // "ftsH" // "degS" // "degQ" // "clpP"
"purine biosynthesis"	"purR" // "purM" // "purL" // "purC" // "purA" // "guaB"
"purine ribonucleotide biosynthesis"	"gmk"
"Putative uncharacterized transport protein"	"yccA" // "wza" // "mntP"
"pyridoxal 5'phosphate"	"gapA"
"pyrimidine biosynthesis"	"pyrF" // "pyrC" // "purR" // "carA"
"pyrimidine ribonucleotide biosynthesis"	"cmk"
"pyruvate dehydrogenase"	"aceE"
"pyruvate oxidation"	"poxB"
"radiation"	"uvrB" // "uvrA" // "nfo"
"regulation"	"purR" // "typA"
"regulon"	"treR" // "soxS" // "purR" // "oxyR" // "lexA" // "fadR" // "cytR" // "cbl" // "asnC"
"repressor"	"yneJ" // "tyrR" // "trpR" // "treR" // "torR" // "soxS" // "soxR" // "rcsA" // "rcnR" // "putA" // "purR" // "pspF" // "oxyR" // "ompR" // "nrdR" // "mprA" // "mlc" // "metJ" // "malI" // "lrp" // "lexA" // "ilvY" // "ihfB" // "hns" // "glcC" // "gcvR" // "gcvA" // "galS" // "galR" // "fnr" // "fadR" // "cytR" // "csgD" // "crp" // "bolA" // "asnC" // "argR" // "arcA" // "araC" // "aidB" // "ada"
"riboflavin"	"ribA"
"ribosomal proteins"	"rpsU" // "rpsM" // "rpsF" // "rplU"
"ribosomes"	"ssrA" // "rpsU" // "rpsM" // "rpsF" // "rplU" // "rimP"
"RNA"	"rne" // "rnc" // "rnb"
"RNA degradation"	"ssrA" // "rraB" // "rne" // "rnc" // "rnb" // "hfq" // "csrB" // "csrA"
"RNA modification"	"rlmE" // "pcnB" // "mnmG" // "dusB"
"RNA related"	"ryfD" // "rybA"
"serine"	"serC" // "serA"
"sigma factors, anti-sigmafactors"	"rsd" // "rpoH" // "rpoE"
"SOS response"	"uvrD" // "uvrB" // "uvrA" // "sulA" // "ssb" // "recA" // "lexA" // "dinI"
"starvation"	"dps" // "dksA" // "cstA"
"stimulon"	"rsd" // "rpoH" // "rpoE"
"sugar nucleotide biosynthesis, conversions"	"manA"
"sulfur metabolism"	"sufA" // "cysJ" // "cysD" // "cbl"
"surface antigens (ECA, O antigen of LPS)"	"waaA" // "rcsA" // "galE" // "dsrA"
"TCA cycle"	"sdhC" // "mdh" // "icdA" // "acnB"
"temperature extremes"	"ybeD" // "rpoH" // "rpoE" // "ppiD" // "clpP" // "typA"
"The H+- or Na+-translocating F-type, V-type and A-type ATPase (F-ATPase) Su"	"atpI"
"The P-type ATPase (P-ATPase) Superfamily"	"zntA" // "mgtA" // "kdpF"
"The Type II (General) Secretory Pathway (IISP) Family"	"secG"
"thioredoxin, glutaredoxin"	"trxC" // "trxA"
"threonine catabolism"	"metB"
"Transcription related"	"yneJ" // "yebK" // "uvrY" // "tyrR" // "trpR" // "treR" // "torR" // "topA" // "soxS" // "soxR" // "sdiA" // "rsd" // "rpoZ" // "rpoH" // "rpoE" // "rhaS" // "rcsA" // "hepA" // "qseB" // "putA" // "purR" // "pspF" // "pepA" // "oxyR" // "ompR" // "mprA" // "mlrA" // "mlc" // "metJ" // "melR" // "malT" // "malI" // "lrp" // "lexA" // "leuO" // "ilvY" // "ihfB" // "hns" // "greA" // "glcC" // "gcvR" // "gcvA" // "galS" // "galR" // "gadE" // "fnr" // "fadR" // "cytR" // "cusR" // "csgD" // "crp" // "cbl" // "caiF" // "cadC" // "bolA" // "asnC" // "argR" // "arcA" // "araC" // "ada"
"transcriptional level"	"yebK" // "sutR" // "ssrS" // "hepA" // "qseB" // "nemR" // "mlrA" // "greA"
"translation"	"ssrA" // "rpsU" // "rpsM" // "rpsF" // "rplU" // "pth" // "infA" // "dsrA" // "dksA" // "typA" // "arfA"
"translation attenuation and efficiency"	"hfq" // "dksA" // "csrA"
"transport"	"lolA" // "copA"
"Transporters of Unknown Classification"	"rcnA" // "cirA"
"transposon related"	"cusC"
"tRNA"	"argX"
"tryptophan"	"trpR" // "trpL" // "mtr" // "aroH"
"turnover, degradation"	"yccA" // "ssrA" // "recA" // "ptrA" // "pepD" // "pepA" // "lon" // "ftsH" // "degS" // "degQ" // "clpP"
"two component regulatory systems (external signal)"	"torR" // "rcsD" // "qseB" // "ompR" // "glrK" // "dcuS" // "cpxP" // "arcA"
"tyrosine"	"tyrP" // "tyrB"
"unassigned reversible reactions"	"nfsB" // "can" // "caiF"
"UNCLASSIFIED"	"yifL" // "yhjR" // "yhfA" // "yhdH" // "yeaR" // "ycaR" // "ybhL" // "ybdL" // "mraZ" // "bcsE"
"unknown"	"yjjQ" // "uspA" // "dctA"
